edge = destrezza
wits = ingegno
momentum = impeto
supply = mosse
shadow = ombra
heart = cuore

Aid Your Ally = "Aiutare un alleato"
Battle = "Dare battaglia"
Clash = "Scontrarsi"
Compel = "Costringere" **
Draw the Circle = "Tracciare il cerchio" ??????
End the Fight = "Termina il combattimento"
Endure Stress = "Sopporti lo stress"
Enter the Fray = "Entrare nella mischia"
Face Danger = "Affronti il pericolo"
Face Death = "Affronti la morte"
FORGE A BOND = "Formare un legame"
Fulfill Your Vow = "Porta a compimento il tuo giuramento"
Gather Information = "Raccogliere informazioni"
Reach Your Destination = "Raggiungi la tua destinazione"
Resupply = "Rifornire"
Secure an Advantage = "Assicuri un vantaggio"
Strike = "Colpire"
Swear an Iron Vow = "Prestare un giuramento sul ferro"
TEST YOUR BOND = "Mettere alla prova il tuo legame"
TURN THE TIDE = Ribaltare le sorti
Undertake a Journey = "Intraprendi un viaggio"
Write Your Epilogue = "Scrivi il tuo epilogo"



https://effortlessmountain.github.io/ironsworn-asset-workbench/


*FACE DANGER
*SECURE AN ADVANTAGE
*GATHER INFORMATION
*RESUPPLY
*HEAL
*MAKE CAMP
*UNDERTAKE A JOURNEY
*REACH YOUR DESTINATION





Giocare a Giuramenti di ferro
Nel gioco di ruolo da tavolo Giuramenti di ferro, sei un eroe che ha giurato di compiere pericolose imprese nell’ambientazione fantastica e oscura delle Terre di Ferro. Attraverserai terre selvagge inesplorate, combatterai battaglie disperate, stabilirai legami con comunità isolate e rivelerai i segreti di queste lande desolate. Soprattutto, presterai dei giuramenti d’acciaio e li porterai a compimento, a qualunque costo.
Per giocare a Giuramenti di ferro, crei il tuo personaggio, prendi decisioni sul mondo in cui vivi e metti in moto la storia. Quando ti trovi di fronte a qualcosa di pericoloso o incerto, le tue scelte e i dadi determinano l’esito.
In Giuramenti di ferro tu e uno o più persone giocate insieme per superare sfide e compiere imprese, senza la necessità di un GM. Il sistema di gioco vi aiuterà a esplorare le storie drammatiche dei vostri personaggi e dei loro fatidici giuramenti.
Giuramenti di ferro è progettato principalmente per piccoli gruppi, fino a quattro giocatori. I personaggi interpretati dagli altri giocatori sono definiti dalle regole come tuoi alleati.










